8, 8
0, 0, 5, 5, 5, 0, 0, 0
0, 0, 5, 4, 5, 0, 0, 0
0, 0, 5, 2, 5, 5, 5, 5
5, 5, 5, 3, 1, 3, 4, 5
5, 4, 2, 3, 3, 5, 5, 5
5, 5, 5, 5, 4, 5, 0, 0
0, 0, 0, 5, 2, 5, 0, 0
0, 0, 0, 5, 5, 5, 0, 0