19, 11
0, 0, 0, 0, 5, 5, 5, 5, 5, 0, 0, 0, 0, 0, 0, 0, 0, 0, 0
0, 0, 0, 0, 5, 2, 2, 2, 5, 0, 0, 0, 0, 0, 0, 0, 0, 0, 0
0, 0, 0, 0, 5, 3, 2, 2, 5, 0, 0, 0, 0, 0, 0, 0, 0, 0, 0
0, 0, 5, 5, 5, 2, 2, 3, 5, 5, 0, 0, 0, 0, 0, 0, 0, 0, 0
0, 0, 5, 2, 2, 3, 2, 3, 2, 5, 0, 0, 0, 0, 0, 0, 0, 0, 0
5, 5, 5, 2, 5, 2, 5, 5, 2, 5, 2, 2, 2, 5, 5, 5, 5, 5, 5
5, 2, 2, 2, 5, 2, 5, 5, 2, 5, 5, 5, 5, 5, 2, 2, 4, 4, 5
5, 2, 3, 2, 2, 3, 2, 2, 2, 1, 2, 2, 2, 2, 2, 2, 4, 4, 5
5, 5, 5, 5, 5, 2, 5, 5, 5, 2, 5, 2, 5, 5, 2, 2, 4, 4, 5
0, 0, 0, 0, 5, 2, 2, 2, 2, 2, 5, 5, 5, 5, 5, 5, 5, 5, 5
0, 0, 0, 0, 5, 5, 5, 5, 5, 5, 5, 0, 0, 0, 0, 0, 0, 0, 0