14, 10
5, 5, 5, 5, 5, 5, 5, 5, 5, 5, 5, 5, 0, 0
5, 4, 4, 2, 2, 5, 2, 2, 2, 2, 2, 5, 5, 5
5, 4, 4, 2, 2, 5, 2, 3, 2, 2, 3, 2, 2, 5
5, 4, 4, 2, 2, 5, 3, 5, 5, 5, 5, 2, 2, 5
5, 4, 4, 2, 2, 2, 2, 1, 2, 5, 5, 2, 2, 5
5, 4, 4, 2, 2, 5, 2, 5, 2, 2, 3, 2, 5, 5
5, 5, 5, 5, 5, 5, 2, 5, 5, 3, 2, 3, 2, 5
0, 0, 5, 2, 3, 2, 2, 3, 2, 3, 2, 3, 2, 5
0, 0, 5, 2, 2, 2, 2, 5, 2, 2, 2, 2, 2, 5
0, 0, 5, 5, 5, 5, 5, 5, 5, 5, 5, 5, 5, 5